9  9  9  9  9  9  9  9  9  9  9  9  9  9  9  9  9  9  9  9  9  
9  9  9  9  9  9  9  9  9  9  9  9  9  9  9  9  9  9  9  9  9  
9  24 17 17 17 17 17 17 17 17 17 17 17 17 17 17 17 17 17 17 17  
9  10 57 57 57 57 57 57 57 57 57 57 57 57 57 57 57 57 57 57 57  
9  10 57 57 57 57 57 57 57 57 57 57 57 57 57 57 57 57 57 57 57
9  10 57 57 57 57 57 57 57 57 57 57 57 57 57 57 57 57 57 57 57  
9  10 57 57 57 57 57 57 57 57 57 57 57 57 57 57 57 57 57 57 57 
9  10 57 57 57 57 57 57 57 57 57 57 57 57 57 57 57 57 57 57 57 
9  10 57 57 57 57 57 57 57 57 57 57 57 57 57 57 57 57 57 57 57 
9  10 57 57 57 57 57 57 57 57 57 57 57 57 57 57 57 57 57 57 57  
9  10 57 57 57 57 57 57 57 57 57 57 57 57 57 57 57 57 57 57 57  
17 18 57 57 57 57 57 57 57 57 57 57 57 57 57 57 57 57 57 57 57  
57 57 57 57 57 57 57 57 57 57 57 57 57 57 57 57 57 57 57 57 57  
57 57 57 57 57 57 57 57 57 57 57 57 57 57 57 57 57 57 57 57 57  
1  1  1  1  1  1  1  1  1  1  1  1  1  1  1  1  1  1  1  2  57  
9  9  9  9  9  9  9  9  9  9  9  9  9  9  9  9  9  9  9  10 57  

