10 10 10 10 10 10 10 10 10 10 10 10 10 10 10 10 10 10 10 10 10 
10 10 10 10 10 10 10 10 10 10 10 10 10 10 10 10 10 10 10 10 10 
10 10 10 10 10 10 10 10 10 10 10 10 10 10 10 25 18 18 18 18 18 
10 10 10 10 10 10 10 10 10 10 10 10 10 10 25 19 58 58 58 58 58 
10 10 10 10 10 10 10 10 10 10 10 10 10 25 19 58 58 58 58 58 58 
10 10 10 10 10 10 10 10 10 10 10 10 25 19 58 58 58 58 58 58 58 
10 10 10 10 10 10 10 10 10 10 10 25 19 58 58 58 58 58 58 58 58 
10 10 10 10 10 10 10 10 10 10 25 19 58 58 58 58 58 58 58 58 58 
10 10 10 10 10 10 10 10 10 25 19 58 58 58 58 58 58 58 58 58 58 
10 10 10 10 10 10 10 10 25 19 58 58 58 58 58 58 58 58 58 58 58 
10 10 10 10 10 10 10 25 19 58 58 58 58 58 58 58 58 58 58 58 58 
18 18 18 18 18 18 18 19 58 58 58 58 58 58 58 58 58 58 58 58 58 
58 58 58 58 58 58 58 58 58 58 58 58 58 58 58 58 58 58 58 58 58 
58 58 58 58 58 58 58 58 58 58 58 58 58 58 58 58 58 58 58 58 58 
2  2  2  2  2  2  2  2  2  2  2  2  2  2  2  2  2  2  2  3  58 
10 10 10 10 10 10 10 10 10 10 10 10 10 10 10 10 10 10 10 11 58
