51 51 51 51 51 51 51 51 51 51 51 51 51 51 51 51 51 51 51 51 51
51 51 51 51 51 51 51 51 51 51 51 51 51 51 51 51 51 51 51 51 51
51 51 51 51 51 51 51 51 51 51 51 51 51 51 51 51 51 51 51 51 51
51 51 51 51 51 51 51 51 51 51 51 51 51 51 51 51 51 51 51 51 51
51 51 51 51 51 51 51 51 51 51 51 51 51 51 51 51 51 51 51 51 51
51 51 51 51 51 51 51 51 51 51 51 51 51 51 51 51 51 51 51 51 51
51 51 51 51 51 51 51 51 51 51 51 51 51 51 51 51 51 51 51 51 51
51 51 51 51 51 51 51 51 51 51 51 51 51 51 51 51 51 51 51 51 51
51 51 51 51 51 51 51 51 51 51 51 51 51 51 51 51 51 51 51 51 51
51 51 66 67 68 66 67 68 51 51 51 51 51 51 51 51 51 51 51 51 51
51 51 82 83 84 82 83 84 51 51 51 51 51 51 51 51 51 51 51 51 51
51 51 98 99 100 98 99 100 51 51 51 51 51 51 51 51 51 51 51 51 51
51 51 114 115 116 114 115 116 51 51 51 51 51 51 51 51 51 51 51 51 51
51 51 118 131 51 51 131 118 51 51 51 51 51 51 51 51 51 51 51 51 51
51 0 0 0 0 0 0 0 0 0 0 0 0 0 0 0 0 0 0 0 51
51 16 16 16 16 16 16 16 16 16 16 16 16 16 16 16 16 16 16 16 51