9  9  9  9  9  9  9  9  9  9  9  9  9  9  9  9  9  9  9  9  9  
9  9  9  9  9  9  9  9  9  9  9  9  9  9  9  9  9  9  9  9  9  
17 17 17 17 17 17 17 17 17 17 17 17 17 17 17 17 17 17 17 17 17  
57 57 57 57 57 57 57 57 57 57 57 57 57 57 57 57 57 57 57 57 57  
57 57 57 57 57 57 57 57 57 57 57 57 57 57 57 57 57 57 57 57 57  
57 57 57 57 57 57 57 57 57 57 57 57 57 57 57 57 57 57 57 57 57  
57 57 57 57 57 57 57 57 57 57 57 57 57 57 57 57 57 57 57 57 57  
57 57 57 57 57 57 57 57 57 57 57 57 57 57 57 57 57 57 57 57 57  
57 57 57 57 57 57 57 57 57 57 57 57 57 57 57 57 57 57 57 57 57  
57 57 57 57 57 57 57 57 57 57 57 57 57 57 57 57 57 27 57 57 57  
57 57 57 57 57 57 57 57 57 57 57 57 57 57 27 57 57 35 57 57 57  
57 57 57 57 57 57 57 57 57 57 57 27 57 57 35 57 57 35 57 57 57  
57 57 57 57 57 57 57 57 27 57 57 35 57 57 43 57 57 43 57 57 57  
57 57 57 57 57 27 57 57 43 57 57 43 57 57 43 57 57 43 57 57 57  
57 0  1  1  1  41  1  1  41  1  1  41  1  1  41  1  1  41  1  2  57  
57  8  9  9  9  9  9  9  9  9  9  9  9  9  9  9  9  9  9  10 57  

