10 10 10 10 10 10 10 10 10 10 10 10 10 10 10 10 10 10 10 10 10
10 10 10 10 10 10 10 10 10 10 10 10 10 10 10 10 10 10 10 10 10
18 18 18 18 18 18 18 18 18 18 18 18 18 18 18 18 18 18 18 18 18
58 58 58 58 58 58 58 58 58 58 58 58 58 58 58 58 58 58 58 58 58
58 58 58 58 58 58 58 58 58 58 58 58 58 58 58 58 58 58 58 58 58
58 58 58 58 58 58 58 58 58 58 58 58 58 58 58 58 58 58 58 58 58
58 58 58 58 58 58 58 58 58 58 58 58 58 58 58 58 58 58 58 58 58
58 58 58 58 58 58 58 58 58 58 58 58 58 58 58 58 58 58 58 58 58
58 58 58 58 58 58 58 58 58 58 58 58 58 58 58 58 58 58 58 58 58
58 58 58 58 58 58 58 58 58 58 58 58 58 58 58 58 58 28 58 58 58
58 58 58 58 58 58 58 58 58 58 58 58 58 58 28 58 58 36 58 58 58
58 58 58 58 58 58 58 58 58 58 58 28 58 58 36 58 58 36 58 58 58
58 58 58 58 58 58 58 58 28 58 58 36 58 58 44 58 58 44 58 58 58
58 58 58 58 58 28 58 58 44 58 58 44 58 58 44 58 58 44 58 58 58
58 01 02 02 02 42 02 02 42 02 02 42 02 02 42 02 02 42 02 03 58
58 09 10 10 10 10 10 10 10 10 10 10 10 10 10 10 10 10 10 11 58
