10 10 10 10 10 10 10 10 10 10 10 10 10 10 10 10 10 10 10 10 10
10 10 10 10 10 10 10 10 10 10 10 10 10 10 10 10 10 10 10 10 10
18 18 18 18 18 18 18 18 18 18 18 18 18 18 18 18 18 18 18 18 18
58 58 58 58 58 58 58 58 58 58 58 58 58 58 58 58 58 58 58 58 58
58 58 58 58 58 58 45 46 47 58 58 58 58 58 45 46 47 58 58 58 58
58 58 58 58 58 58 58 58 58 58 58 58 58 58 58 58 58 58 58 58 58
58 58 45 46 47 58 58 58 58 58 45 46 47 58 58 58 58 58 45 46 47
58 58 58 58 58 58 58 58 58 58 58 58 58 58 58 58 58 58 58 58 58
58 58 58 58 58 58 45 46 47 58 58 58 58 58 45 46 47 58 58 58 58
58 58 58 58 58 58 58 58 58 58 58 58 58 58 58 58 58 58 58 58 58
58 58 58 58 58 58 58 58 58 58 45 46 47 58 58 58 58 58 45 46 47
58 58 45 46 47 58 58 58 58 58 58 58 58 58 58 58 58 58 58 58 58
58 58 58 58 58 58 45 46 47 58 58 58 58 58 45 46 47 58 58 58 58
58 58 58 58 58 58 58 58 58 58 58 58 58 58 58 58 58 58 58 58 58
58 01 02 02 02 02 02 02 02 02 02 02 02 02 02 02 02 02 02 03 58
58 09 10 10 10 10 10 10 10 10 10 10 10 10 10 10 10 10 10 11 58
