52 52 52 52 52 52 52 52 52 52 52 52 52 52 52 52 52 52 52 52 52
52 52 52 52 52 52 52 52 52 52 52 52 52 52 52 52 52 52 52 52 52
52 52 52 52 52 52 52 52 52 52 52 52 52 52 52 52 52 52 52 52 52
52 52 52 52 52 52 52 52 52 52 52 52 52 52 52 52 52 52 52 52 52
52 52 52 52 52 52 52 52 52 52 52 52 52 52 52 52 52 52 52 52 52
52 52 52 52 52 52 52 52 52 52 52 52 52 52 52 52 52 52 52 52 52
52 52 52 52 52 52 52 52 52 52 52 52 52 52 52 52 52 52 52 52 52
52 52 52 52 52 52 52 52 52 52 52 52 52 52 52 52 52 52 52 52 52
52 52 52 52 52 52 52 52 52 52 52 52 52 52 52 52 52 52 52 52 52
52 52 52 52 52 52 52 52 52 52 52 52 52 52 52 52 52 66 67 68 52
52 52 52 52 52 52 52 52 52 52 52 52 52 52 52 52 52 82 83 84 52
52 52 52 52 52 52 49 52 52 52 52 52 52 52 52 52 52 98 99 100 52
52 52 52 52 52 0 0 0 0 9 10 11 0 0 52 52 52 114 115 116 52
52 52 52 0 0 16 17 17 17 52 52 52 16 16 52 52 52 52 131 52 52
52 0 0 16 16 17 16 17 16 52 52 52 16 16 52 0 0 52 0 0 52
52 16 16 16 1 16 16 16 16 52 52 52 16 16 52 16 16 52 1 1 52