9  9  9  9  9  9  9  9  9  9  9  9  9  9  9  9  9  9  9  9  9  
9  9  9  9  9  9  9  9  9  9  9  9  9  9  9  9  9  9  9  9  9  
17 17 17 17 17 17 17 17 17 17 17 17 17 17 17 17 17 17 17 17 17  
57 57 57 57 57 57 57 57 57 57 57 57 57 57 57 57 57 57 57 57 57  
57 57 57 57 57 57 44 45 46 57 57 57 57 57 44 45 46 57 57 57 57  
57 57 57 57 57 57 57 57 57 57 57 57 57 57 57 57 57 57 57 57 57  
57 57 44 45 46 57 57 57 57 57 44 45 46 57 57 57 57 57 44 45 46  
57 57 57 57 57 57 57 57 57 57 57 57 57 57 57 57 57 57 57 57 57  
57 57 57 57 57 57 44 45 46 57 57 57 57 57 44 45 46 57 57 57 57  
57 57 57 57 57 57 57 57 57 57 57 57 57 57 57 57 57 57 57 57 57  
57 57 57 57 57 57 57 57 57 57 44 45 46 57 57 57 57 57 44 45 46  
57 57 44 45 46 57 57 57 57 57 57 57 57 57 57 57 57 57 57 57 57  
57 57 57 57 57 57 44 45 46 57 57 57 57 57 44 45 46 57 57 57 57  
57 57 57 57 57 57 57 57 57 57 57 57 57 57 57 57 57 57 57 57 57  
57  0  1  1  1  1  1  1  1  1  1  1  1  1  1  1  1  1  1  2  57  
57  8  9  9  9  9  9  9  9  9  9  9  9  9  9  9  9  9  9  10 57  
