52 52 52 52 52 52 52 52 52 52 52 52 52 52 52 52 52 52 52 52 52
52 52 52 52 52 52 52 52 52 52 52 52 52 52 52 52 52 52 52 52 52
52 52 52 52 52 52 52 52 52 52 52 52 52 52 52 52 52 52 52 52 52
52 52 52 52 52 52 52 52 52 52 52 52 52 52 52 52 52 52 52 52 52
52 52 52 52 52 52 52 52 52 52 52 52 52 52 52 52 52 52 52 52 52
52 52 52 52 52 52 52 52 52 52 52 52 52 52 52 52 52 52 52 52 52
52 52 52 52 52 52 52 52 52 52 52 52 52 52 52 52 52 52 52 52 52
52 52 52 52 52 52 52 52 52 52 52 52 52 52 52 52 52 52 52 52 52
52 52 52 52 52 52 52 52 52 52 66 67 68 52 52 52 52 52 52 52 52
52 52 52 52 52 52 52 52 52 52 82 83 84 52 52 52 52 52 52 52 52
52 52 52 52 52 52 52 52 52 52 98 99 100 52 52 52 52 52 52 52 52
52 52 52 52 52 52 52 52 52 52 114 115 116 52 52 52 52 52 52 52 52
52 52 52 52 52 52 52 52 52 52 97 131 52 52 52 0 52 52 52 52 52
52 52 52 135 52 52 52 52 52 0 0 0 0 52 52 16 0 0 132 52 52
52 0 0 0 0 0 0 52 52 16 16 17 16 52 52 16 16 16 0 0 52
52 16 16 16 16 16 16 52 52 16 16 16 16 52 52 16 16 16 16 16 52