10 10 10 10 10 10 10 10 10 10 10 10 10 10 10 10 10 10 10 10 10
10 10 10 10 10 10 10 10 10 10 10 10 10 10 10 10 10 10 10 10 10
18 18 18 18 18 18 18 18 18 18 18 18 18 18 18 18 18 18 18 18 18
58 58 58 58 44 58 58 58 44 58 58 58 44 58 58 58 44 58 58 58 58
58 58 58 58 44 58 58 58 44 58 58 58 44 58 58 58 44 58 58 58 58
58 58 58 58 44 58 58 58 44 44 44 44 44 58 58 58 44 58 58 58 58
58 58 58 58 44 58 58 58 58 58 58 58 58 58 58 58 44 58 58 58 58
58 58 58 58 58 58 58 58 58 58 58 58 58 58 58 58 58 58 58 58 58
58 58 58 58 58 58 58 58 58 01 02 03 58 58 58 58 58 58 58 58 58
58 58 58 58 58 58 58 58 58 09 10 11 58 58 58 58 58 58 58 58 58
58 58 58 58 58 58 01 02 02 43 10 41 02 02 03 58 58 58 58 58 58
58 58 58 58 58 58 09 10 10 10 10 10 10 10 38 58 58 58 58 58 58
58 58 58 01 02 02 43 10 10 10 10 10 10 10 41 02 02 03 58 58 58
58 58 58 09 10 10 10 10 10 10 10 10 10 10 10 10 10 11 58 58 58
58 01 02 43 10 10 10 10 10 10 10 10 10 10 10 10 10 41 02 03 58
58 09 10 10 10 10 10 10 10 10 10 10 10 10 10 10 10 10 10 11 58
