9  9  9  9  9  9  9  9  9  9  9  9  9  9  9  9  9  9  9  9  9  
9  9  9  9  9  9  9  9  9  9  9  9  9  9  9  9  9  9  9  9  9  
17 17 17 17 17 17 17 17 17 17 17 17 17 17 17 17 17 17 17 17 17  
57 57 57 57 43 57 57 57 43 57 57 57 43 57 57 57 43 57 57 57 57  
57 57 57 57 43 57 57 57 43 57 57 57 43 57 57 57 43 57 57 57 57  
57 57 57 57 43 57 57 57 43 43 43 43 43 57 57 57 43 57 57 57 57  
57 57 57 57 43 57 57 57 57 57 57 57 57 57 57 57 43 57 57 57 57  
57 57 57 57 57 57 57 57 57 57 57 57 57 57 57 57 57 57 57 57 57  
57 57 57 57 57 57 57 57 57  0  1  2 57 57 57 57 57 57 57 57 57  
57 57 57 57 57 57 57 57 57  8  9 10 57 57 57 57 57 57 57 57 57  
57 57 57 57 57 57  0  1  1 42  9 40  1  1  2 57 57 57 57 57 57  
57 57 57 57 57 57  8  9  9  9  9  9  9  9 37 57 57 57 57 57 57  
57 57 57  0  1  1 42  9  9  9  9  9  9  9 40  1  1  2 57 57 57  
57 57 57  8  9  9  9  9  9  9  9  9  9  9  9  9  9 10 57 57 57  
57  0  1 42  9  9  9  9  9  9  9  9  9  9  9  9  9 40  1  2 57  
57  8  9  9  9  9  9  9  9  9  9  9  9  9  9  9  9  9  9 10 57  

